NO textures/redbrick.xpm
SO textures/redbrick.xpm
WE textures/redbrick.xpm
EA textures/redbrick.xpm

C 150,0,0
F 81,4,4
1
                  1
111111111        101
100000001         1
100000001
100000001
1000N0001        1
100000001
100000001
100000001
111111111  1
 
     1
 
 
 
 
1111111
101  101
 1    1 
 
 
 
1           1   1   