NO textures/wall_no.xpm
SO textures/wall_so.xpm
WE textures/wall_we.xpm
EA textures/wall_ea.xpm

F 184,113,39
C 51,198,227

1111  1  111     111
1011  1  10111111101
101   11110100010101
10111 10000100100001
10001 10111110100111
10001 100000001011
11111 1000S001001
    1 101110100011
111111101010100001
1010000110100000011
1010011100101111101
1011101001101   101
1001101011001   101
1001101110011   101
1001001 1011   1101
1011001 101    1001
 110001 111  111001
1111101      100001
  1 111   1111101111
11            111 11
